Antoine Girard	Dijon	Oui
Aymé d'Eschenon maire de Dijon	Dijon
Bernard de l'Olive	Dijon
Bernard Humbelot	Dijon
Charles Le Téméraire	Cour
Collette La Camuse	Inconnue
Drouot de Marnay	Dijon
Etienne Berbisey	Dijon
Frère Jean Jaquier	Inconnue
Girard Le Coq	Paris	Oui
Girard Mareschal	Dijon
Guillaume Billocard	Dijon	Oui
Guillemin Le Jeune	Dijon
Henri	Dijon
Huguenin Boudier	Dijon
Huguenin Girart	Dijon
Humbelin Langeolet	Dijon
Isabelle de Portugal	Cour
Jacot Martin	Dijon
Jacques Borestel	Dijon	Oui
Jean Bricet	Dijon
Jean de Gray	Paris	Oui
Jean de Molesmes	Dijon
Jean de Rossay	Dijon
Jean des Dames de Montbéliard	Inconnue
Jean Gaucher clerc Michel de Pons	Montbéliard
Jean Gros	Paris	Oui
Jean Guénéaul	Dijon	Oui
Jean Lanternier	Dijon
Jean Martin	Dijon
Jean Rabustel	Dijon
Jeanne fille Isabeau femme Huot	Dijon	Oui
Jeanne Rabustel	Dijon
La femme de Girard Le Coq	Dijon
La femme de Jean Bricet	Paris
La femme de Jean Gros	Paris
La femme de Michel Pons	Dijon
La femme de Pierre Baudot	Paris
La femme Pierre Berbis	Dijon
La femme Simon Naissant	Dijon
La nourrice	Dijon
Le beau-fils de Sybille Mutin	Dijon
Le chancelier de Bourgogne	Inconnue
Le clerc de Girard Le Coq	Cour
Le clerc de Pierre Fusée	Paris	Oui
Le frère de Jean Cousin	Paris	Oui
Le procureur du roi	Dijon
Le procureur ducal	Paris	Oui
Les enfants de Jean Rabustel	Paris	Oui
Les frères et sœurs et la mère d'Antoine Girard	Dijon
Mairie de Soisson	Dijon
Mairie de Dijon	Soisson
Maître Mathieu, cousin de Pierre Fusée	Dijon
Marguerite d'York	Paris	Oui
Mathelin Chenin	Cour
Me Guillaume David procureur de R Alardot	Dijon
Me Guillaume de Gamay	Paris	Oui
Me Jean Bricet	Paris	Oui
Me Jean Fouquault	Paris	Oui
Me Thibaut Garnot	Paris	Oui
Michel de Pons	Paris	Oui
Michelotte	Paris	Oui
Mgr de Tournay	Cour
Nicolas Bastier	Cour
Nicolas de Leaune	Dijon	Oui
Odot Douay	Inconnue
Philiberte Rabustel	Dijon
Philippe de Courcelles	Dijon
Philippe Douhet	Dijon
Philippe Genevoise	Dijon
Philippe Le Bon	Chalon
Philippe Luillier	Cour
Pierre Baudot	Paris	Oui
Pierre Bonféal	Dijon
Pierre de Cologne	Dijon
Pierre de Lattre	Strasbourg
Pierre Fusée	Dijon
Pierre Lesuoley	Paris	Oui
Pierre Rabustel	Dijon	Oui
Ranconjour	Dijon	Oui
Simon Naissant	Inconnue	Oui
Sybille Mutin veuve Jean de Rossay	Dijon
Thibaud Liégeart	Inconnue
Une femme de l'hôtel	Dijon	Oui
Ysabeau femme Huot	Dijon
Mongin La Corne	Dijon
Jacques Rabustel	Dijon
Philippe Martin	Dijon
